********************************************************************************************************************************
********************************************************************************************************************************
********************************************************************************************************************************
********************************************************************************************************************************
********************************************************************************************************************************
********************************************************************************************************************************
********************************************************************************************************************************
********************************************************************************************************************************
********************************************************************************************************************************
********************************************************************************************************************************
********************************************************************************************************************************
********************************************************************************************************************************
********************************************************************************************************************************
********************************************************************************************************************************
********************************************************************************************************************************
********************************************************************************************************************************
********************************************************************************************************************************
********************************************************************************************************************************
::::::::::::********************************************************************************************************************
............********************************************************************************************************************
............********************************************************************************************************************
88..........********************************************************************************************************************
8888........::::::::::::::::::::::::::::::::::::::::::::::::::::::::::::::::::::::::::::::::::::::::::::::::::::::::::::::::::::
88888888888888888888888888888888888888888888888888888888888888888888888888888888888888888888888888888888888888888888888888888888